,Name,G,Rush Yards,Pass Yards,Plays,Total Yards,Yards/Play,Yards/G
1,Ohio State,12,2234,4379,850,6613,7.78,551.1
2,Western Kentucky,12,1229,5073,895,6302,7.04,525.2
3,Virginia,12,1485,4711,892,6196,6.95,516.3
4,Pittsburgh,12,1873,4280,942,6153,6.53,512.8
5,Mississippi,12,2691,3389,929,6080,6.54,506.7
6,Coastal Carolina,12,2775,3142,776,5917,7.63,493.1
7,Alabama,12,1804,4102,889,5906,6.64,492.2
8,Kent State,12,2969,2892,912,5861,6.43,488.4
9,Wake Forest,12,2017,3786,923,5803,6.29,483.6
10,North Carolina,12,2640,3119,844,5759,6.82,479.9
11,Marshall,12,1918,3731,883,5649,6.4,470.8
12,Florida,12,2508,3133,844,5641,6.68,470.1
13,SMU,12,1937,3654,890,5591,6.28,465.9
14,Western Michigan,12,2431,3136,893,5567,6.23,463.9
15,Fresno State,12,1602,3961,877,5563,6.34,463.6
16,Tennessee,12,2544,2964,848,5508,6.5,459
17,Utah State,12,1838,3657,920,5495,5.97,457.9
18,BYU,12,2237,3238,810,5475,6.76,456.3
19,Michigan,12,2699,2715,845,5414,6.41,451.2
20,Louisville,12,2536,2867,809,5403,6.68,450.3
21,Mississippi State,12,767,4630,902,5397,5.98,449.8
22,Miami (Florida),12,1532,3854,879,5386,6.13,448.8
23,Central Michigan,12,2182,3191,895,5373,6,447.8
24,USC,11,1603,3315,822,4918,5.98,447.1
25,Nebraska,12,2162,3197,832,5359,6.44,446.6
26,Baylor,12,2735,2617,819,5352,6.53,446
27,Georgia,12,2427,2883,752,5310,7.06,442.5
28,UCLA,12,2581,2714,854,5295,6.2,441.3
29,Arkansas,12,2608,2683,824,5291,6.42,440.9
30,North Texas,12,2954,2335,969,5289,5.46,440.8
31,Oklahoma,12,2104,3183,781,5287,6.77,440.6
32,Appalachian State,12,2269,3010,838,5279,6.3,439.9
33,Nevada,12,885,4390,855,5275,6.17,439.6
34,Maryland,12,1568,3685,875,5253,6,437.8
35,Iowa State,12,2023,3226,797,5249,6.59,437.4
36,TCU,12,2355,2875,783,5230,6.68,435.8
36,Memphis,12,1645,3585,861,5230,6.07,435.8
38,Tulsa,12,2252,2969,861,5221,6.06,435.1
39,Utah,12,2624,2593,814,5217,6.41,434.8
40,Oregon,12,2568,2645,820,5213,6.36,434.4
41,UTSA,12,2144,3054,858,5198,6.06,433.2
41,East Carolina,12,1945,3253,899,5198,5.78,433.2
43,Toledo,12,2323,2873,789,5196,6.59,433
44,Cincinnati,12,2133,3043,760,5176,6.81,431.3
45,Oregon State,12,2608,2557,802,5165,6.44,430.4
46,Michigan State,12,2227,2937,793,5164,6.51,430.3
47,Kentucky,12,2473,2686,787,5159,6.56,429.9
48,Liberty,12,2123,3020,828,5143,6.21,428.6
49,Northern Illinois,12,2778,2340,840,5118,6.09,426.5
50,Miami (Ohio),12,1716,3391,801,5107,6.38,425.6
51,Texas,12,2391,2705,803,5096,6.35,424.7
52,Air Force,12,4104,990,884,5094,5.76,424.5
53,Purdue,12,999,4082,887,5081,5.73,423.4
54,Houston,12,1791,3269,833,5060,6.07,421.7
55,Duke,12,2166,2855,934,5021,5.38,418.4
56,Notre Dame,12,1830,3163,814,4993,6.13,416.1
57,Colorado State,12,1969,3020,911,4989,5.48,415.8
58,North Carolina State,12,1514,3461,815,4975,6.1,414.6
59,Missouri,12,2147,2798,847,4945,5.84,412.1
60,Texas Tech,12,1808,3099,753,4907,6.52,408.9
61,Oklahoma State,12,2289,2604,886,4893,5.52,407.8
62,Louisiana-Lafayette,12,2308,2571,813,4879,6,406.6
63,Buffalo,12,2283,2583,906,4866,5.37,405.5
64,Auburn,12,1971,2894,832,4865,5.85,405.4
65,Hawai'i,13,1857,3408,893,5265,5.9,405
66,Charlotte,12,1798,3044,822,4842,5.89,403.5
67,Arizona State,12,2453,2371,754,4824,6.4,402
68,UCF,12,2264,2532,791,4796,6.06,399.7
68,Florida Atlantic,12,1821,2975,835,4796,5.74,399.7
70,California,11,1888,2476,732,4364,5.96,396.7
71,Arkansas State,12,989,3767,873,4756,5.45,396.3
72,Army,11,3319,1030,755,4349,5.76,395.4
73,UTEP,12,1728,2980,791,4708,5.95,392.3
74,Texas A&M,12,2196,2503,788,4699,5.96,391.6
75,Washington State,12,1564,3109,790,4673,5.92,389.4
76,Tulane,12,1977,2661,823,4638,5.64,386.5
77,Old Dominion,12,2022,2613,867,4635,5.35,386.3
78,West Virginia,12,1541,3083,841,4624,5.5,385.3
79,UAB,12,2119,2494,733,4613,6.29,384.4
80,Louisiana Tech,12,1467,3141,826,4608,5.58,384
81,Eastern Michigan,12,1416,3163,827,4579,5.54,381.6
82,Penn State,12,1279,3293,860,4572,5.32,381
82,Boise State,12,1444,3128,869,4572,5.26,381
84,Georgia State,12,2663,1896,835,4559,5.46,379.9
85,Florida State,12,2132,2419,786,4551,5.79,379.3
86,Wisconsin,12,2585,1945,809,4530,5.6,377.5
87,LSU,12,1313,3169,840,4482,5.34,373.5
88,Ohio,12,2248,2209,748,4457,5.96,371.4
89,New Mexico State,12,1206,3236,890,4442,4.99,370.2
90,Virginia Tech,12,2283,2156,781,4439,5.68,369.9
91,South Alabama,12,1337,3072,846,4409,5.21,367.4
92,Florida International,12,1225,3182,750,4407,5.88,367.3
92,Georgia Tech,12,2027,2380,786,4407,5.61,367.3
94,Syracuse,12,2562,1836,778,4398,5.65,366.5
95,Clemson,12,2056,2298,830,4354,5.25,362.8
96,Rice,12,1794,2540,821,4334,5.28,361.2
97,Wyoming,12,2341,1988,776,4329,5.58,360.8
98,Minnesota,12,2325,1997,794,4322,5.44,360.2
99,Kansas State,12,1928,2335,685,4263,6.22,355.3
100,Arizona,12,1548,2711,870,4259,4.9,354.9
101,Middle Tennessee,12,1449,2764,835,4213,5.05,351.1
102,South Florida,12,1902,2309,841,4211,5.01,350.9
103,Boston College,12,1971,2217,783,4188,5.35,349
104,Texas State,12,1772,2322,829,4094,4.94,341.2
105,San Jose State,12,1441,2645,755,4086,5.41,340.5
106,Georgia Southern,12,2319,1765,811,4084,5.04,340.3
107,Akron,12,1463,2610,785,4073,5.19,339.4
108,Troy,12,1187,2850,785,4037,5.14,336.4
109,Ball State,12,1625,2406,803,4031,5.02,335.9
110,San Diego State,12,2127,1851,788,3978,5.05,331.5
111,Illinois,12,2083,1874,790,3957,5.01,329.8
112,Louisiana-Monroe,12,1566,2328,854,3894,4.56,324.5
113,Kansas,12,1672,2218,754,3890,5.16,324.2
114,Washington,12,1181,2700,779,3881,4.98,323.4
115,South Carolina,12,1469,2373,762,3842,5.04,320.2
116,Northwestern,12,1691,2128,817,3819,4.67,318.3
117,Bowling Green,12,1228,2578,777,3806,4.9,317.2
118,Rutgers,12,1706,2064,832,3770,4.53,314.2
119,Vanderbilt,12,1480,2272,830,3752,4.52,312.7
120,UNLV,12,1317,2434,727,3751,5.16,312.6
121,Stanford,12,1042,2582,697,3624,5.2,302
122,Massachusetts,12,1764,1832,748,3596,4.81,299.7
123,Iowa,12,1454,2135,780,3589,4.6,299.1
124,Indiana,12,1370,2106,818,3476,4.25,289.7
125,Temple,12,1315,2126,724,3441,4.75,286.8
126,Navy,11,2521,599,736,3120,4.24,283.6
127,Southern Mississippi,12,1449,1746,752,3195,4.25,266.3
128,Connecticut,12,1195,1970,784,3165,4.04,263.8
129,Colorado,12,1516,1575,707,3091,4.37,257.6
130,New Mexico,12,1444,1366,725,2810,3.88,234.2